:::::::::::::::::::::::::::::::::::::::::::::::::::::::::
::  #   ::                                             ::
:: ###  ::                                             ::
::      ::                                             ::
::      :::::::::::::::::                 :::::::######::
::#######              ::                 ::           ::
::  #       ####       ::                 ::           ::
::  # # # # ####       ::                 ::           ::
::  ######  ####       ::                 ::           ::
::  #                  ::                 ::           ::
::#####################::                 ::           ::
::       ####          ::                 ::           ::
::       ####          :::::::::::::::::::::           ::
::       ####          #         ::                    ::
::       ##     #####  #         ::                    ::
::###################  #         ::                    ::
::        ####   ####  #         ##                    ::
::        ####         #         ##                    ::
::        ####         #         ##                    ::
:::::::::::::::::::::::::::::::::::::::::::::::::::::::::
